SwitchPack	KEYWORD1
Debounce	KEYWORD1
debouncePin	KEYWORD2
pin	KEYWORD2
setSensitivity	KEYWORD2
getSensitivity	KEYWORD2
Contact	KEYWORD1
begin	KEYWORD2
closed	KEYWORD2
open	KEYWORD2
rose	KEYWORD2
fell	KEYWORD2
Click	KEYWORD1
clicked	KEYWORD2
Toggle	KEYWORD1
readStatus	KEYWORD2
getStatus	KEYWORD2
setStatus	KEYWORD2
DoubleClick	KEYWORD1
clickCount	KEYWORD2
setMaxClicks	KEYWORD2
setLimit	KEYWORD2
TimedClick	KEYWORD1
wasLastRead	KEYWORD2
clickTime	KEYWORD2
timeSinceLastClick	KEYWORD2
Repeater	KEYWORD1
repeatRequired	KEYWORD2
setStart	KEYWORD2
setBurst	KEYWORD2
ModeSwitch	KEYWORD1
readMode	KEYWORD2
getMode	KEYWORD2
resetAfter	KEYWORD2
Encoder	KEYWORD1
setPins	KEYWORD1
setModes	KEYWORD2
stepsPerClick	KEYWORD2
getRotation	KEYWORD2
getCount	KEYWORD2
setCount	KEYWORD2
resetCount	KEYWORD2
CW	LITERAL1
CCW	LITERAL1
PULLUP	LITERAL1
PULLDOWN	LITERAL1
ON	LITERAL1
OFF	LITERAL1

